Словничок Закарпатського говору.
(Докінчення)
Лі́ска, лі́са — хвіртка
Лути́ння — лозина, хворостина з ліщини
Ма́чка — кішка, кішки
Меже́ — поміж, між
Ми — мені
Му — йому
Ме́но — ім’я
Мета́ти — кидати
Ма́рга — скотина, товар
Мня́тво — м’ята
Мно́го — багато
Ми́ндра — рід горілки з денатур. спірту
Най — хай, нехай
Небора́к — нещасний, сірома 
Ня — мене
Неволя́шний — ні до чого (людина)
Небо́ра — сірома
Ногави́ці — штани
Наза́д — знов
Ни́ґда — ніколи
Ні ку́с, нич — нічого
О́болок, о́блочок — вікно, віконце
 Ож (не прийде) — що (не прийде)
Орса́ґ — держава (в розум. Мад’ярщина)
Орса́цький — державний (мадярський)
Обста́тися — лишитися
Обру́чка — перстень 
Отпусти́ти — вибачити
Оціло́ва — сталева, з криці
Огва́ри — оговори, плітки Окіл — біля, коло
Па́чка — пакунок тютюну 25 gr. 
Па́ленка — горілка
Пу́кати — тріскати, тріщати
Позира́ти — дивитися
Попіля́ — коло, біля
Пой, подь — іди́, ходи́
По́тя — птах, птиця 
Пи́сок — морда
Пия́ти — пити (горілку, алкоголь);
Півдру́га — півтора
Пі́д — горіще
Поле́вка — суп
Півста́ти — перестати
Пелеха́тий — розтріпаний
Пилува́ти — спішити 
Пробалува́ти — пробувати
Повіда́ти — говорити, оповідати 
Плати́нка — хустинка
Па́трити — стежити, слідкувати 
Поку́ртити — скоротити
Пу́тик — доріжка
Піша́к — стежка
Прока́ртяти — програти в карти
Пру́тик — лозинка
Піздри́ти — подивитися
Пу́шка — рушниця
Посука́ти — поламати, побити 
Позі́р давати — уважати
Пачма́ґи — штани, шаравари
Пеку́чка — кавун, диня
Пла́ття — білізна
Плат – нага́ч — попере́дник (фартух) не цілий, з поясом
Плат — попере́дник цілий, aж на плечі
Па́нтлик — стрічка, бинда
Пі́па — люлька
Плати́на — біла хустка на голову
Ру́жа — квітка
Розказа́ти — наказа́ти
Руковати — йти на військову службу
Рінь, Ріни́ця — рінь, дрібний камінь
Рацьнова́ти — рачкувати, лазити 
Розмари́на — рід квітки
Ро́йти — ажур долі на штанинах
Рева́ти — плакати, ревіти
Стра́тити — загубити
Спира́ти — здержувати
Ся — себе
Сту́рнас — ґанок
Серенча́ — щастя 
Серенчли́вий — щасливий
Скла́мати — обдурити, обманути 
Савти́ря — псалтир
Сере́к — серед, посередені 
Сома́р — осел
Спра́вити — зробити
Сабе́лка — шабля
Спі́ванка — пісня
Студено́ — холодно
Сукман — суконка, спідниця 
Сабі́вка — шевкиня
Сно́чи — вчора увечері 
Сирохма́н — сіро́ма
Тоти́ — ті
Тя — тебе
Ти — тобі
Трепе́точка — осика
Туй — тут
Тко — хто
Тве́рдо — дуже, міцно
Тету́ла — пані, цяця (згірдливо) 
Тенґериця — кукурудза
Теметю́ — цвинтар
Тра́фити — влучити
Тру́дно — сумно, смутно 
Таркани́стий — рябий (собака) 
Уддава́тися — виходити заміж 
Успівати — виспівати
Уді́сідь — відціля
Упити — випити
Уше́тко — все
Фа́йний — гарний, красний
Фра́їр, -ка — полюбовник, любчик
Фурма́нка — прилавок у корчмі 
Хлоп — парубок
Хиби́ти — бракувати, не вистачати
Хи́жа — хата
Ху́сточка — хустинка
Хлебта́ти — сьорбати 
Хосен — користь
Ци — чи
Цімбора́ — при́ятель 
Цоркоті́ти — брязкотіти 
Чалова́ти — дурити, обманювати 
Черле́ний — червоний
Чини́ти — робити 
Чи́зми — чоботи
Чудни́ця — дивниця, дивовина 
Часть — ві́но, придане
Чі́чка — квітка
Черни́ця — ожина
Чей — може
Што — що
Шу́мний — гарний, красний 
Шкребта́ти — скребтати 
Шти́ри — чотири
Шаркантьо́ви — остро́ги (у кіннотчиків)
Шва́блики — сірнички 
Шири́нка — хустка
Шелеля́кий — всілякий 
Шпіта́ль — лічниця 
Шор, за шо́ром — ряд, уря́д 
Ю — її
Ярь — весна
Яре́ць — ячмінь 
Яли́вка — телиця
Лисичово, 1 травня 1936. 
     
