Доповнення до »Лемківського словника “.
У 22 та 23 числах „Рідної Мови“ помістив д. М. Приймак „Лемківського словничка“ помітніших слів, що їх записав у західній Лемківщині. Щоб цей Словничок доповнити, подаю помітніші лемківські слова, що їх нема ні в „Словничку“ д. Приймака, ні в словнику І. Верхратського. Ці слова записані переважно в селах: Маластові, Пантній, Бортнім, Рихвалді, Грабі, Дальовій, Яслиськах, Липівці, Карликові, Полонній, Петровій-Волі та Чистогорбі. Додаю, що наголос все на передостанньому складі. При нагоді пригадаю, що тепер уже покійний о. Зиновій Флюнт, бувши парохом у Грабі, зібрав повний словничок говору цього ж села. Цей словничок у руках його синів.
Асентраґи (асантраґи, Hosenträger) — шлейки. 
Байсак — хлопець.
безгарство — пуста балачка.
бетега — ганьба. У словнику Верхратського „бетега“ — нездара.
босорити — ворожити.
Вабійка, вайбійка, вабія — коритце.
вдовий — удовець.
верекатися — (у Верх, „верабожкатися") — божитися, присягатися.
вестка (die Weste) — камізоля. 
вихвилитися — випогодитися. 
возниця — віконце на дах у курній хаті. 
Гамар — крик.
гауптак (гууптак) — дурень.
глевиш — картопляна юшка.
горван — ворон.
Грівниці — Стрітення. 
гуляк — весела забава.
гримцувати — скакати. 
Доімати — посуджувати. 
дурбак — брусок до коси.
дудрати — воркотіти.
душатися — заклинатися на душу.
душитися — змучитися.
Ердек (ördög) — чорт. 
Заслухатися — недочути.
змазурити — забрудити. 
Кармани — білі спідниці. 
карванити — бідувати.
кеньчик — видаток.
коўпак — шапка з баранячої шкури.
колися — колись.
корчнявий — майкут, шульга, лівак.
кости — штучні погної.
кулкар — („kółko*)—склепар. 
кусціцерний — манюсінький.
Лупкач — батіг.
льопи — плітки.
лялючити — годувати (дитину). 
Масник — облесна людина.
матина — томасина.
молоджава — молодь. 
Наґаб — напасть.
недолугий — нездібний (niedołężny).
нутвак — нездаль, „оферма“.
ніт хто — нема кому. 
Облоки — вікна.
оле? — о?
омерза — біда, недоля.
огріство — гріхи.
отцвикати (abzwicken) — відрізати.
Пантлики (pętelka) — стяжка.
паточки — сірники.
пахолок (pachołek) — хлопець.
півка — половина.
Пільша — Польща.
пила — тартак.
пипка — люлька. 
Резовиня — трачиння. 
реберація (rabacja) — бунт, крики.
решетавіти — трупішити.
росівка — мішок на збіжжя до сівби.
світло — явно.
скиси — пивниця (бо там кисне молоко).
скіпа — щепа.
стрижок — більше лоша, що йому вже підстригають гриву.
сціґош — добрий крутій.
Темениця — тім’я. Фанта — вдова, фляґа (plaga) — біда.
фолечний — (також „фалачний“) упертий.
фрас — чорт.
Хоробатн — проклинати хворобою. 
Цеперити — бити.
Сянік.
