Словничок Закарпатського говору.
Подаю тут коротенького Словничка слів с. Івашковиця, Іршавської округи на Закарпатті.
Андека — о́сьдечки, о́сьде, 
Аче́й — може, та вжеж. 
Айв — так, еге ж.
Ба́нда — музика (оркестра). 
Банова́ти — жаліти, шкодувати. 
Ба́ность — жаль.
Босорка́ня — відьма. 
Бетя́р — пройди́світ.
Бетярчу́к — пройдисвіт 
Баршу́н — бархат 
Бреха́ч — брехун
Барна́стий — смушевий 
Берві́нок — барвінок 
Бирі́в, -ка — староста, -тиха 
Божи́тися — вінчатися 
Брост — бруньки на деревах 
Бовч — ставок
Бу́ритися — наступає буря 
Ва́рош — місто
Вари́ська — мійська 
Вандрова́ти — мандрувати 
Вби́сьме — щоб ми, аби ми 
В’є́дно — разом 
Вби́ — щоб, аби
В’я́чок — вояк, жовнір 
Вши́тко — все
Во́лки — волики
Віґа́н — дівоче плаття (для дітей та підлітків)
Ви́дитися — здаватися 
Ви́шній — горішній 
Вся́ди — скрізь 
Во́зір — вікно 
Ви́хор — вітер 
Гада́ти — думати 
Ганьби́тися — соромитися 
Го́шитися — нахвалятися, грозитися
Гид — гадюка
Го — його
Гу́слі, гусе́лка — скрипка 
Горі́— на верху
Грати — танцювати 
Га́рдо — гордо, пишно 
Гуча́ти — дзюрчати, шуміти 
Груньо́к — горбок 
Густи́ — грати (музика) 
Гу́нцут — пройди́світ 
Го́йкати — кричати
Ги́нде — он там, о́нде, о́ндечки 
Герти́ка — сухо́ти, туберкульоза 
Гев — сюди
Ґаздова́ти — господарювати 
Ґре́йцар — крейцар
Ґа́ті — штани 
Ґроф — граф
Ґро́вський — графський 
Ґо́мбиця — ґудзик 
Ґвер — рушниця
Дя́ка — охота, бажання
Добрі́ — добре
Дідик — дідусь
Да́рьмо — дурно, даром
Ду́ркати — стукати 
Дутки́ — гроші
Діло́к — гора покрита лісом (діл) 
До́ста — досить
Ди́чка — груша
Дра́чка — шипшина, дика троянда
Д горі́ — до гори
Доді́вчити — додівувати
Дяладова́ти — насміхатися, глузувати
До́льки — доленька
Домі́в — додому 
Да́ґде — десь
Довжа́нка — глечик
Дійти́— скінчити
Єде́н — один
Єперка — шовковиця (дерево) 
Жа́чко — кисет, гаманець на тютюн
Жальо́к — жаль, сум
Жура́ — смуток
Жеболовка — носова хустинка 
Залуче́ний — заручений 
Зада́рьмо — дурно, даром 
За́дарь — дурно, даром
За́кидь — доки
За́то — тому
Заганя́ти — посилати 
Завола́ти — закликати
Зи́мний — холодний
З ки́м — доки
Иця — міра (4 літрі)
Ї — її
Кату́н — вояк, військо
Кой прийдеш — коли (прийдеш) 
Ке́дь би — коли б
Кишели́сті — рябі 
Коси́ця — квітки
К апа́та — ухаста, каплауха 
Когу́т — півень
Ка́вка — галка
Коструба́тий — розтріпаний 
Коло́пні — коноплі
Камара́т — приятель
Клино́к — кілок у стіні 
Клинці́ — цвяхи, цвяшки 
Ку́ртий — короткий
Ка́ртяти — грати в карти 
Каба́т — пальто
Катіня́та — штанці 
Комонии́ця — люцерна
Курга́з — лічниця, шпиталь 
Кураго́в — хоругва
Кост — харчі, страва 
Кошу́ля (рідко) — сорочка 
Клебань — бриль
Коле́нки — короткі штани до колін із застьожкою модерне)
Ко́вдош — жебрак, старець
Кима́к — вулик
Капу́ра — хвіртка
Кистеме́н — чорна хустка на голову
Лем — лише, тільки
Личи́ти — лічити, рахувати
Леґі́нь — парубок, юнак
Ла́ти — лаяти
Леда́ч — лодар
Лячи́ — лягти 
(Кінець буде).
Інж. Мих. Кириченко
